11111111111111111
1P101C10000000011
10000000E01000011
100000C0001000011
11111111111111111